MConfigSmartFolderMonitor                   | "Aktualizovat panely pouze pokud je Far aktivní"                                  
MConfigSortingCollation                     | "Řazení:"         
MConfigSortingOrdinal                       | "ordinal"                    
MConfigSortingInvariant                     | "invariant"                  
MConfigSortingLinguistic                    | "lingvistický"                 
MConfigSortingDigitsAsNumbers               | "Pracovat s číslicemi jako s čísly"    
MConfigTreeLabel1                           | "Uložit soubor se strukturou složek jako:"                                
MConfigTreeLabelLocalDisk                   | "místní disky"               
MConfigTreeLabelNetDisk                     | "síťové disky"             
MConfigTreeLabelNetPath                     | "síťové cesty"              
MConfigTreeLabelRemovableDisk               | "vyměnitelné disky"           
MConfigTreeLabelCDDisk                      | "optické disky"             
MConfigTreeLabelExceptPath                  | "Nevytvářet soubor pro následující disky a cesty:"                  
MConfigTreeLabelSaveLocalPath               | "Cesta pro místní, vyměnitelné a optické disky:"                           
MConfigTreeLabelSaveNetPath                 | "Cesta pro síťové disky a cesty:"                                     
MConfigRightClickSelect                     | "Klik pravým tlačítkem vybere soubory"  
MConfigDetailedJunction                     | "Detekovat připojovací &body"
MConfigDoubleStripeSeparator                | "Dvojité oddělovače hlavních sloupců"                                    
MConfigSetConsoleIcon                       | "Nastavit ikonu okna konzole"           
MConfigSetAdminConsoleIcon                  | "Alternativní ikona pro správce"
MConfigInfoPanelCNTitle                     | "Formát &názvu počítače"      
MConfigInfoPanelCNPhysicalNetBIOS           | "Fyzický NetBIOS"           
MConfigInfoPanelCNPhysicalDnsHostname       | "Fyzický DNS název hostitele"      
MConfigInfoPanelCNPhysicalDnsDomain         | "Fyzická DNS doména"        
MConfigInfoPanelCNPhysicalDnsFullyQualified | "Fyzická DNS s celým názvem"
MConfigInfoPanelCNDnsHostname               | "DNS název hostitele"               
MConfigInfoPanelCNDnsDomain                 | "DNS doména"                 
MConfigInfoPanelCNDnsFullyQualified         | "DNS s celým názvem"        
MConfigInfoPanelUNTitle                     | "&User name format"          
MConfigInfoPanelUNFullyQualifiedDN          | "Plně kvalifikovaný doménový název"
MConfigInfoPanelUNSamCompatible             | "Sam kompatibilní"             
MConfigInfoPanelUNDisplay                   | "Zobrazované jméno"               
MConfigInfoPanelUNUniqueId                  | "Unikátní Id"                  
MConfigInfoPanelUNCanonical                 | "Kanonický název"             
MConfigInfoPanelUNUserPrincipal             | "User Principial Name"       
MConfigInfoPanelUNServicePrincipal          | "Service Principal"          
MConfigInfoPanelUNDnsDomain                 | "DNS Domain"                 
MViewConfigDefaultCodePage                  | "Výchozí stránka kódování:"         
MEditConfigCursorAtEnd                      | "Kurzor je na konci"          
MEditConfigDefaultCodePage                  | "Výchozí stránka kódování:"         
MCopyBytesTotalInfo                         | "Bajtů:"                     
MRecycleFolderConfirm                       | "Tato složka bude přesunuta do koše:"                 
MRecycleFolderConfirmDeleteLink1            | "Složka obsahuje symbolické odkazy."                                        
MRecycleFolderConfirmDeleteLink2            | "Chcete-li zabránit ztrátě obsahu při vyprázdnění koše"          
MRecycleFolderConfirmDeleteLink3            | "those links will be broken now."                                        
MRecycleFolderConfirmDeleteLink4            | "Nebude možné je později obnovit."                          
MCannotRecycleFile                          | "Nemohu přesunout soubor do koše"                                    
MCannotRecycleFolder                        | "Nemohu přesunout složku do koše"                                  
MEditSearchPickWord                         | "Slovo"                       
MEditSearchPickSelection                    | "Výběr"                  
MEditSearchPreserveStyle                    | "&Zachovat styl"             
MGoToHex                                    | "&Hexadecimální hodnota"                 
MFSShortcutPluginData                       | "Data:"                      
MEditorReloadCPWarnLost1                    | "Pro změnu kódové stránky musí být soubor znovu načten."                           
MEditorReloadCPWarnLost2                    | "Všechny neuložené změny budou ztraceny."                                      
MListPlaceholder                            | "Zástupce"                
MListFileSize                               | "Bajty: {0}, soubory: {1}, složky: {2}"                                   
MFindFileAllCodePages                       | "Všechny kódové stránky"     
MFindFileSelectedCodePages                  | "Vybrané kódové stránky"        
MFindAlternateStreams                       | "Hledat v alternativních streamech"
MSearchNotContaining                        | "Neobsahuje"             
MGetCodePageEditCodePageName                | "Upravit název kódové stránky"
MChangeDriveCannotDetach                    | "Nemohu odpojit virtuální disk {0}"                                         
MChangeSUBSTDisconnectDriveTitle            | "Odpojování virtuálního zařízení"                                        
MChangeSUBSTDisconnectDriveQuestion         | "Odpojit virtuální disk {0}?"    
MChangeDriveShowSizeFloat                   | "Zobrazit velikost jako desetinný zlomek"                                        
MQuickViewPlaceholder                       | "Zástupce"                
MQuickViewUnknownReparsePoint               | "Unknown reparse point"      
MQuickViewMFTOverhead                       | "MFT overhead:"              
MSetAttrDfsTargets                          | "DFS cíly"                
MSetAttrIntegrityStream                     | "Integrity stream"           
MSetAttrNoScrubData                         | "No scrub data"              
MSetConfirmRemoveSUBST                      | "Odpojení virtuálního d&isku"      
MEditMenuConfirmation                       | "Uložit změny?"              
MEditMenuError                              | "Nemohu aktualizovat menu"         
MViewSearchEod                              | "Dosažen konec souboru"
MViewSearchBod                              | "Dosažen začátek souboru"                                          
MViewSearchCycle                            | "Celý soubor byl prohledán" 
MViewSearchRepeat                           | "Opakovat hledání v souboru?"                                     
MMacroPluginLuamacroNotLoaded               | "Plugin LuaMacro není nahrán"                                          
MMacroRecordingIsDisabled                   | "Nahrávání maker je vypnuto"
MExcDetails                                 | "Detaily:"                   
MExcSource                                  | "Zdroj:"                    
MExcStack                                   | "Stack"                      
MExcMinidump                                | "Minidump"                   
MInfoCtrlF12                                | "Mode"                       
MFileFilterAttrIntegrityStream              | "Integrity stream"           
MFileFilterAttrNoScrubData                  | "No scrub data"              
MCompletionEnvironmentTitle                 | "Prostředí"                
MObjectLockedAndMore                        | "a {0} více procesů."    
MObjectLockedReasonSessionMismatch          | "Jeden nebo více procesů běží v instanci terminálových služeb."
MObjectLockedReasonCriticalProcess          | "Jeden nebo více procesů jsou kritické procesy."                          
MObjectLockedReasonCriticalService          | "Jeden nebo více procesů jsou kritické služby."                            
MObjectLockedReasonDetectedSelf             | "Soubor je otevřen tímto procesem."                             
MBadLanguageFile                            | "Chybný jazykový soubor"    
MLanguageStringNotFound                     | "Řetězec {0} nebyl nalezen"       
